NO ./textures/test/north.xpm
SO ./textures/test/south.xpm
WE ./textures/test/west.xpm
EA ./textures/test/east.xpm
F 50,50,50
C 20,20,20

11111111111
10000000001
10000100001
10000E00001
10000000001
10000000001
11111111111
