



NO ./textures/wolfenstein/blue_stone.xpm
SO ./textures/wolfenstein/purple_stone.xpm
WE ./textures/wolfenstein/color_stone.xpm
EA ./textures/wolfenstein/red_brick.xpm
F 220,100,0
C 225,30,0

1111111111111111111111111111
1000000000000000000000000001
1000000000111111000000000001
11111000001    1000000000001
1000000000111111000000011111
100000000000000000000000N001
1111111111111111111111111111
